R 1280 720

NO ./res/textures/cursor.xpm
SO ./res/textures/cursor.xpm
WE ./res/textures/cursor.xpm
EA ./res/textures/cursor.xpm
S ./res/textures/cursor.xpm

F 81,90,90
C 153,163,164
                                                                                                                
                                                                                                                
                                  1111111111                                                                    
                          11111111000000000011111111                                                            
                      1111000000000000000000000000001111                                                        
                  111100000000000000000000000000000000001111                                                    
              111100000000000000000000000000000000000000000011                                                  
            111100000000000000000000000000000000000000000000001111                                              
          1111000000000000000000000000000000000000000000000000001111                                            
        111100000000000000000000000000000000000000000000000000000011                                            
        11000000000000000000000000000000000000000000000000000000000011                                          
      110000000000000000000000000000000000000000000000000000000000000011                                        
    11110000000000000000000000000000000000000000000000000000000000000011                                        
    1100000000000000000000000000000000000000000000000000000000000000000011                                      
    1100000000000000000000000000000000000000000000000000000000000000000011                                      
  11000000000000000000000000000000000000000000000000000000000000000000000011                                    
  11000000000000000000000000000000000000000000000000000000000000000000000011                                    
  11000000000000000000000000000000000000000000000000000000000000000000000011                                    
1100000000000000000000000000000000000000000000000000000000000000000000000011                                    
110000000000000000000000000000000000000000000000000000000000000000000000000011                                  
110000000000000000000000000000000000000S00000000000000000000000000000000000011                                  
110000000000000000000000000000000000000000000000000000000000000000000000000011                                  
110000000000000000000000000000000000000000000000000000000000000000000000000011                                  
110000000000000000000000000000000000000000000000000000000000000000000000000011                                  
110000000000000000000000000000000000000000000000000000000000000000000000000011                                  
1100000000000000000000000000000000000000000000000000000000000000000000000011                                    
  11000000000000000000000000000000000000000000000000000000000000000000000011                                    
  11000000000000000000000000000000000000000000000000000000000000000000000011                                    
  110000000000000000000000000000000000000000000000000000000000000000000011                                      
    1100000000000000000000000000000000000000000000000000000000000000000011                                      
    1100000000000000000000000000000000000000000000000000000000000000001111                                      
      110000000000000000000000000000000000000000000000000000000000000011                                        
      1111000000000000000000000000000000000000000000000000000000000011                                          
        11110000000000000000000000000000000000000000000000000000001111                                          
          1100000000000000000000000000000000000000000000000000001111                                            
            111100000000000000000000000000000000000000000000001111                                              
              11110000000000000000000000000000000000000000001111                                                
                1111000000000000000000000000000000000000001111                                                  
                    11110000000000000000000000000000001111                                                      
                        111111000000000000000000111111                                                          
                              111111111111111111                                                                
                                                                                                                
