R 1280 720

NO ./res/textures/cursor.xpm
SO ./res/textures/cursor.xpm
WE ./res/textures/cursor.xpm
EA ./res/textures/cursor.xpm
S ./res/textures/cursor.xpm

F 81,90,90
C 153,163,164




                              111
                  111111111111000111111111111
                  100000000000000000000000001
                  100000000000000000000000001                 11111111                  
                  100000000000000000000000001           11111100000000111111            
                  100000000000000000000000001       1111000000000000000000001111        
                  100000000000000000000000001     11000000000000000000000000000011      
                  100000000000000000000000001   110000000000000000000000000000000011    
                  100000000000000000000000001   100000000000000000000000000000000001    
                  100000001111101111100000001 1100000000000000000000000000000000000011  
                  100000001000000000100000001 1000000000000000000000000000000000000001  
                  100000001000000000100000001 1000000000000000000000000000000000000001  
                  1000000010000000001000000011000000000000000000000000000000000000000011
                 100000000100000000010000000000000000000000000000000000000000000000000001
                 100000000000000000000000000000000000000000000000000000000000000000000001
                 100000000100000000010000000000000000000000000000000000000000000000000001
                  1000000010000000001000000011000000000000000000000000000000000000000011
                  100000001000000000100000001 1000000000000000000000000000000000000001  
                  100000001000000000100000001 1000000000000000000000000000000000000001  
                  100000001111101111100000001 1100000000000000000000000000000000000011  
                  100000000000000000000000001   100000000000000000000000000000000001    
                  100000000000000000000000001   110000000000000000000000000000000011     
                  100000000000000000000000001     11000000000000000000000000000011      
                  100000000000000000000000001       1111000000000000000000001111        
                  100000000000000000000000001           11111100000000111111            
                  100000000000000000000000001                 11000011                  
                  100000000000000000000000001                  10001                     
                  111111111111000111111111111                  10001           
                          10000000001                          10001        
                          10000000001                          10001     
                          10000000001                          10001 
                          100000000011111111111111111111111111110001    
                          100000000000000000000000000000000000000001
                          10000W000000000000000000000000000000000001     
                          100000000000000000000000000000000000000001
                          100000000011111111111111111111111111111111
                          10000000001
                          10000000001
                          11111111111
