R 1280 720

NO ./res/textures/dev.xpm
SO ./res/textures/dev.xpm
WE ./res/textures/dev.xpm
EA ./res/textures/dev.xpm
S ./res/textures/dev.xpm

F 112,112,112
C 56,56,56

                            111111111111111                     
                            111111111111111                     
     111111                 100000000000111111                  
     100001      11111111111100000000000111111                  
     1000011     10000000000100000000000100011                  
     1000001     10000000000000000000000000011                  
     1000001     10000000000100000000000100011                  
     11111011111 10001111111100000000000111111                  
     10000000001 10001      100000000000111111                  
     1000000000111000111    11111101111111                      
     1000000000100000001    11111000111111                      
     1000000000000000001      111000111111                      
     1000000000100000001      11100011                          
111111000000000111111111      11100011                          
1000110000000001          11111110001111                        
1000111111011111          11111110001111                        
10001   10001             11000000000011                        
11011   10001             11000110001111                        
1000111110001             11000110001111                        
1000100010001             11000110001111                        
1000000010001             111111100011                          
1000100010001             111111100011              111111111111
1000111111011111               1110111              111111111111
1000110000000001          11111100000111111         110000000011
1000110000000001          10000000000000001111111111110000000011
1000110000000001          10000000000000001111111111110000000011
1000010000000001          10000000000000000100000000010000000011
1000000000000001          10000000000000000000000000000000000011
1000010000000001          10000000000000000100000000010000000011
1000110000000001          10000000000000001111000011110000000011
1000110000000001          10000000000000001  1100111110000000011
1000110000000001          11111100000111111  1100111110000000011
1000111111011111               1110111       1100111111101101111
10001   10001                  1100011       1100111111111111111
1000111110001                  1100011       1100111111111111111
1000100010001                  1100011       11001111111111111  
1000000010001                  1100011       11001110101010111  
1000100010001                  1100011       11000100000000011  
1000111110001                  1100011       11000000000000011  
1000111110001111111111111      1100011       11000100000000011  
100000000000000001000000111    1100011       11111110101010111  
100000000000000000000000001    1100011       11111111111111111  
100000000000000001000000111    1100011                          
1111111111111111110111111 11111110001111111                     
         111001000001     11111111011111111                     
         100001001011     11000010001000011                     
         11100000111      11000000000000011                     
           1101111        11000010001000011                     
            1001          11000010001000011                     
            1001          11111110001111111                     
            1111          11000010001000011                     
                          110E0000000000011                     
                          11000010001000011                     
                          11111110001111111                     
                          11000000000000011                     
                          11000000000000011                     
                          11000000000000011                     
                          11111111111111111                     
