                            JJJJJJJJJJJJJJJ                     
                            JJJKJJJJJKJJJJJ                     
     EEEEEE                 Jm000000000mJJJJJJ                  
     E1144E      EEFFEFFIEFEK00c0~c00c00KJJJJJ                  
     E1164EE     F0000000000J}0000000000J445JJ                  
     E1166HE     E0o0000o000O00000e0~000O0{4KJ                  
     E11600E     F0~00000000J00000000000J555JJ                  
     EFGEFSFEGEE E000EEEIEEFL00}00000000LJJJJJ                  
     F045i0i500F E000E      J00000000000JJJJJJ                  
     I0d00040d~IEF000EFE    JJJKJJNJJKJJJJ                      
     E00}000000F000|000E    JJJJJ000JJJJJJ                      
     F&000c0}00O000o000E      JJJ0~0JJJJJJ                      
     E000000000E00000|0E      JJL0o0LJ                          
EFEFEI6d}0000d0IEFEGEFEE      JJJ000JJ                          
F0z"EE660000000E          JJJJJJJ000JJJJ                        
E0o0FEFGEENEEGFE          JJJJJJJ000JJJJ                        
E000E   E000F             JJK0R}00o00qJJ                        
FENEE   I0o0I             JJ10JJJ000JJJJ                        
E000EEFEE000F             JJ1zJJJ000JJJJ                        
E0o0F00yE000E             JJ2zJJJ000JJJJ                        
E00000o{I0o0I             JJJJJJK0o0KJ                          
E000E005F|0|E             JJJJJJJ000JJ              BBBBBBBBBBBB
F000EFEFEENEEFEE               JJKNKJJ              BAABAAABBBAB
I0o0IE000000000E          FEFEIFl00~lEIEFEE         BAy000a"""AB
F0~0EF0l}000{l0IEEE       El00000~0000000lFFBBBBBBBBBA0~00000"BB
E000EF00o000o00E11E       G000000000000000GBAAABAAABBA00000{00AB
E}000E000000000F13E       E0000000000000000B000000000A00000000BB
E0000O000|0000{V0IE       F00e0000e000{e000O000000000O00000000CB
E0000E000000|00EEEE       F0000000000000000A000000000B00000000BB
E000EE00o000o00F          G0}0000000000000GAAA0000BBAA00ny{n00AB
F000EE0l00000l0I          Fl00000000{0000lF  AA00AAAAB00000000BB
E}00EE000000000E          EEHEFE00000EFHEFE  AB00BAABA000000y0AB
H0o{HEFEEFNEEFFE               EAANBAA       AB00AABBBBA#BA$BABB
E000F   E000E                  AA000BA       AA00BABBBABBBBBBBBB
E000EEEEF}00F                  AB0o0BA       AB00AABBBBBBBBBBBBB
F~00E00bE000E                  AA000BA       AA0|BAAAAAAAAAAAA  
E00000o0I0o{I                  AB000AA       AB00AAB0A0B0BgABA  
F000Fy00F000F                  AB000BA       AA000A000000000AA  
F0o~EEFEE}00F                  AA0o0AA       AA000O000000000CA  
E000FEFEF000EFEFFIEFEGFEF      AB000AB       AB000A00000000xAA  
F000000000000000{E00000{IME    AA000BA       AABAAAB0A0A0A0ABA  
F00000o000|000o00O000{00Q0M    AB000BA       AAAAAAAAAAAAAWAAA  
E00000000000000{0E00000{IME    AB0o0AA            AAA676600A    
EFFEFFEFFEHEEEFEEETFEGEFE   AAAAA0|0BAAAAAA       AX078700AA    
         EMI00EE0U0zE      AABABAANAAAAABAA       AAA67660A     
         M0Q00E00EEFE     ABty00A000A0000BA         AAAAAAA     
         EMI00000EEE      AA0000O0o0O0j00BA                     
           EETEEEE        AA0000A000A0000BA                     
            E00E          AB0000B000B0000BA                     
            EE8E          AAABAAB000AAAAAAA                     
            EEEE          AA0000A000A0000AA                     
                          AB0>0+O0o0Oy00tBA                     
                          AA0000A000A0000AA                     
                          AABBAAB000BAABAAA                     
                          AA00}0000000000AA                     
                          AB00o000o000o{1AA                     
                          AA000000y000000AA                     
                          AACBACABDABCBACAA                     
