                            !!!!!!!!!!!!!!!                     
                            !!!!!!!!!!!!!!!                     
     !!!!!!                 !00000000000!!!!!!                  
     !0000!      !!!!!!!!!!!!00000000000!!!!!!                  
     !0000!!     !0000000000!00000000000!000!!                  
     !00000!     !0A0000A0000000000000000000!!                  
     !00000!     !0000000000!00000000000!000!!                  
     !!!!!0!!!!! !000!!!!!!!!00000000000!!!!!!                  
     !000000000! !000!      !00000000000!!!!!!                  
     !000000000!!!000!!!    !!!!!!0!!!!!!!                      
     !000000000!0000000!    !!!!!000!!!!!!                      
     !0000000000000A000!      !!!000!!!!!!                      
     !000000000!0000000!      !!!0A0!!                          
!!!!!!000000000!!!!!!!!!      !!!000!!                          
!000!!000000000!          !!!!!!!000!!!!                        
!0A0!!!!!!0!!!!!          !!!!!!!000!!!!                        
!000!   !000!             !!000000A000!!                        
!!0!!   !0A0!             !!000!!000!!!!                        
!000!!!!!000!             !!000!!000!!!!                        
!0A0!000!000!             !!000!!000!!!!                        
!00000A0!0A0!             !!!!!!!0A0!!                          
!000!000!000!             !!!!!!!000!!              !!!!!!!!!!!!
!000!!!!!!0!!!!!               !!!0!!!              !!!!!!!!!!!!
!0A0!!000000000!          !!!!!!00000!!!!!!         !!00000000!!
!000!!000000000!          !000000000000000!!!!!!!!!!!!00000000!!
!000!!00A000A00!          !000000000000000!!!!!!!!!!!!00000000!!
!0000!000000000!          !0000000000000000!000000000!00000000!!
!00000000000000!          !00000000000000000000000000000000000!!
!0000!000000000!          !0000000000000000!000000000!00000000!!
!000!!00A000A00!          !000000000000000!!!!0000!!!!00000000!!
!000!!000000000!          !000000000000000!  !!00!!!!!00000000!!
!000!!000000000!          !!!!!!00000!!!!!!  !!00!!!!!00000000!!
!0A0!!!!!!0!!!!!               1110211       !!00!!!!!!!0!!0!!!!
!000!   !000!                  1100021       !!00!!!!!!!!!!!!!!!
!000!!!!!000!                  120A021       !!00!!!!!!!!!!!!!!!
!000!000!000!                  1100021       !!00!!!!!!!!!!!!!  
!00000A0!0A0!                  1200011       !!00!!!0!0!0!0!!!  
!000!000!000!                  1200021       !!000!000000000!!  
!0A0!!!!!000!                  110A011       !!0000000000000!!  
!000!!!!!000!!!!!!!!!!!!!      1200012       !!000!000000000!!  
!0000000000000000!000000!!!    1100021       !!!!!!!0!0!0!0!!!  
!00000A0000000A00000000000!    1200021       !!!!!!!!!!!!!!!!!  
!0000000000000000!000000!!!    120A011                          
!!!!!!!!!!!!!!!!!!0!!!!!!   111110002111111                     
         !!!00!00000!      1121211011111211                     
         !0000!00!0!!     12000010001000021                     
         !!!00000!!!      11000000A00000021                     
           !!0!!!!        11000010001000021                     
            !00!          12000020002000021                     
            !00!          11121120001111111                     
            !!!!          11000010001000011                     
                          120E0000A00000021                     
                          11000010001000011                     
                          11221120002112111                     
                          11000000000000011                     
                          1200A000A000A0011                     
                          11000000000000011                     
                          11321312412321311                     
